...........
.S-------7.
.|.......|.
.|.......|.
.|.......|.
.|.......|.
.|.......|.
.L--7.F--J.
....|.|....
..F-J.L-7..
..|.....|..
..L-----J..
...........
